0010101010
0101010101
1010101010
0000000000
0101010101
1010101010
0101010100